111111111111111111
1P1111001000000011
1011111E1111111111
10000000C000000001
1C0000001111111111
10000C000C00000001
100000000000000001
111111111111111111
