111111111111111111111111111111111111111111111111111111
10P0C00C00C00C0001111111111111111111111111111111111111
100000000000000C01111111111111111111111111111111111111
10E111111C11111111111111111111111111111111111111111111
111111111111111111111111111111111111111111111111111111
