1111111111111111111111111111111111111111111111111111111111111111
1P00001111111111101111111111111111111111111111111111111111111111
1110111111111111101111111111111111111111111111111111111111111111
1000000000000C11111111111111111111111111111111111111111111111111
1100000000000001111111111111111111111111111111111111111111111111
10000000000000E1111111111111111111111111111111111111111111111111
1111111111111111101111111111111111111111111111111111111111111111
1111111111111111111111111111111111111111111111111111111111111111
