1111111111111111111
1P00001111111111101
1110111111111111101
1000000000000C11111
1100000000000001111
10000000000000E1111
1111111111111111101
1111111111111111111
